###########
#.........#
#.#######.#
#.#.....#.#
#.#.###.#.#
#.#...#.#.#
#.#####.#.#
#.......#.#
#########.#
#@........#
###########